29
28
XXXXXXXXXXXXXXXXXXXXXXXXXXXX
S     X     X           X  X
XXXX  X  X  X  XXXXXXX  X  X
X     X  X  X       KX  X  X
X  XXXX  X  XXXXXXX  X  X  X
X        X  X     X  X     X
XXXXXXXXXX  X  XXXX  XXXX  X
X        X  X           X  X
X  XXXXXXX  X  XXXXXXXXXX  X
X           X     X     X  X
X  XXXXXXXXXXXXXXXX  X  X  X
X     X           X  X     X
XXXX  X  XXXXXXX  X  XXXXXXX
X     X  X     X           X
X  XXXX  X  XXXXXXX  X  X  X
X  X     X  X        X  X  X
X  X  XXXX  X  XXXXXXXXXX  X
X     X     X     X        X
XXXXXXX  XXXXXXX  X  XXXX  X
X K   X  X        X  X     X
X  X  X  X  XXXXXXXXXX  XXXX
X  X     X        X     X  X
X  XXXXXXXXXXXXX  X  XXXX  X
X           X     X        X
X  XXXX  XXXX  XXXXXXXXXXXXX
X K   X  X     X           X
XXXX  X  X  XXXXXXXXXXXXX  X
X     X                    E
XXXXXXXXXXXXXXXXXXXXXXXXXXXX