17
52
XXXXXXXXXXXXXXXXXXXXXXXXXXXXXXXXXXXXXXXXXXXXXXXXXXXX
S           X     X              X        X        X
XXXXXXXXXX  XXXX  X  XXXXXXXXXX  X  XXXX  X  XXXX  X
X           X     X        X  X     X     X  X     X
X  XXXXXXXXXX  XXXXXXXXXX  X  XXXXXXX  XXXX  X  XXXX
X  X           X  X     X  X        X        X     X
X  XXXXXXX  XXXX  X  X  X  X  XXXX  XXXX  XXXXXXXXXX
X              X     X  X  X     X        X        X
XXXXXXXXXXXXX  XXXX  X  X  XXXXXXXXXXXXX  X  XXXX  X
X     X     X        X  X     X           X     X  X
X  X  X  X  XXXXXXXXXX  XXXX  X  XXXXXXXXXXXXXXXX  X
X  X     X  X        X     X  X  X     X           X
X  XXXXXXXXXX  XXXX  X  X  X  X  X  X  XXXXXXX  X  X
X           X     X  X  X     X  X  X  X        X  X
XXXXXXXXXX  XXXX  X  XXXXXXXXXX  X  X  X  XXXXXXX  X
X K               X K               X     X        E
XXXXXXXXXXXXXXXXXXXXXXXXXXXXXXXXXXXXXXXXXXXXXXXXXXXX