61
31
+--+--+--+--+--+--+--+--+--+--+--+--+--+--+--+--+--+--+--+--+
   |           |     |        |     |                 |     |
+  +  +--+--+  +  +  +--+  +  +  +  +--+  +--+--+--+  +--+  +
|  |  |        |  |     |  |     |     |  |           |     |
+  +  +  +--+--+  +--+  +  +--+--+--+  +  +--+  +--+--+  +  +
|  |  |  |     |  |     |           |        |           |  |
+  +  +  +--+  +  +  +--+--+--+--+  +--+  +  +--+--+--+--+--+
|  |  |        |  |           |     |     |     |           |
+  +  +  +--+--+  +--+--+--+  +  +--+--+--+--+  +  +--+--+  +
|     |  |        |     |  |  |  |           |  |        |  |
+--+--+  +  +--+--+  +  +  +  +  +--+  +--+  +  +--+--+--+  +
|        |     |     |        |           |  |           |  |
+  +--+--+--+  +  +--+--+--+--+--+--+--+--+  +--+  +--+  +  +
|              |  |     |     |                 |  |     |  |
+--+--+--+--+--+  +  +  +  +  +--+  +--+--+--+--+  +--+  +  +
|  |                 |     |              |           |     |
+  +  +--+--+--+--+--+--+--+--+--+  +--+  +  +--+--+  +--+--+
|  |        |           |     |     |     |  |     |        |
+  +--+--+  +  +--+  +--+  +  +  +--+  +  +  +  +  +--+--+  +
|        |  |     |        |  |  |     |  |  |  |           |
+  +  +--+  +--+  +--+--+--+  +--+  +--+  +  +  +--+--+--+--+
|  |        |     |     |     |     |     |  |  |           |
+  +--+--+  +  +--+  +  +  +--+  +--+  +  +  +  +  +--+--+--+
|        |  |        |  |        |     |  |  |     |        |
+--+--+  +--+--+--+--+  +--+  +--+--+--+--+  +  +--+--+  +  +
|     |  |              |     |        |     |  |     |  |  |
+  +--+  +  +--+--+--+--+  +--+  +--+  +  +--+--+  +  +  +  +
|        |  |     |        |     |     |     |     |     |  |
+--+--+--+  +  +  +--+--+--+  +--+  +--+--+  +  +--+--+--+  +
|           |  |  |     |  |     |        |     |     |     |
+  +--+--+--+  +  +  +  +  +  +--+--+--+  +--+--+  +  +  +--+
|  |           |     |     |        |     |     |  |  |  |  |
+  +  +--+--+--+--+--+--+  +--+--+  +--+  +  +  +  +--+  +  +
|  |        |  |           |     |     |  |  |  |  |        |
+  +--+--+  +  +  +--+--+--+--+  +--+  +--+  +  +  +  +  +--+
|  |     |  |     |                    |     |        |     |
+  +  +  +  +  +--+  +--+--+--+--+--+--+  +--+--+--+--+--+  +
|  |  |     |        |     |           |     |     |     |  |
+  +  +--+--+--+--+--+  +  +  +--+--+--+--+  +  +  +  +  +  +
|     |  |              |  |     |     |     |  |  |  |  |  |
+--+--+  +  +--+--+--+  +  +--+  +  +  +  +--+  +  +  +--+  +
|     |     |     |  |  |  |        |  |  |     |  |        |
+  +--+--+--+  +  +  +  +  +  +  +--+--+  +--+  +  +--+--+--+
|              |        |  |  |  |     |  |     |           |
+  +--+--+--+--+--+  +--+  +  +--+  +  +  +  +--+--+--+  +  +
|  |           |     |  |  |     |  |  |     |           |  |
+  +  +--+--+--+  +--+  +  +  +  +  +  +--+--+  +--+--+--+  +
|              |  |     |  |  |     |                 |     |
+--+--+--+--+  +  +--+  +  +--+--+--+--+  +--+--+--+  +  +--+
|              |        |                 |           |      
+--+--+--+--+--+--+--+--+--+--+--+--+--+--+--+--+--+--+--+--+