27
40
XXXXXXXXXXXXXXXXXXXXXXXXXXXXXXXXXXXXXXXX
S     X        X                       X
XXXX  X  XXXX  XXXX  XXXXXXXXXXXXX  X  X
X     X     X     X  X K   X        X  X
X  XXXX  X  XXXX  X  X  X  X  XXXXXXXXXX
X        X     X  X     X  X           X
XXXXXXXXXXXXX  X  XXXXXXX  XXXXXXXXXX  X
X              X  X  X     X           X
X  XXXXXXXXXXXXX  X  X  XXXX  XXXXXXXXXX
X              X     X  X  X           X
XXXXXXXXXXXXXXXXXXX  X  X  XXXXXXXXXX  X
X                       X     X        X
X  XXXXXXXXXXXXXXXX  XXXXXXX  X  XXXXXXX
X     X              X     X     X     X
XXXX  X  XXXXXXX  XXXXXXX  XXXXXXXXXX  X
X     X  X        X     X  X        X  X
X  XXXX  X  XXXXXXXXXX  X  XXXXXXX  X  X
X  X     X           X  X     X     X  X
X  X  XXXXXXXXXXXXX  X  XXXX  X  XXXX  X
X  X     X           X     X  X  X K   X
X  XXXX  X  XXXXXXXXXXXXX  X  X  X  XXXX
X  X     X        X     X           X  X
X  XXXXXXXXXXXXX  X  X  XXXX  X  XXXX  X
X  X        X     X  X        X        X
X  X  XXXX  X  XXXX  XXXX  X  XXXXXXXXXX
X     X     X        X     X           E
XXXXXXXXXXXXXXXXXXXXXXXXXXXXXXXXXXXXXXXX